{
  "version": 1,
  "tileLegend": {
    ".": "empty",
    "#": "brick",
    "@": "steel",
    "~": "water",
    "%": "forest",
    "_": "ice",
    "B": "base",
    "C": "cracked_brick",
    "G": "glowing_steel",
    "F": "flower_field",
    "L": "lava",
    "M": "mud",
    "R": "road_arrow",
    "P": "bounce_pad",
    "S": "speed_boost",
    "N": "neon_bridge",
    "O": "crater",
    "X": "force_field",
    "T": "switch"
  },
  "notes": [
    "Each layout is 25 columns by 19 rows.",
    "The base is at x=12, y=17 and is protected by bricks.",
    "Levels 1-4 include extra brick barriers in the vertical line of sight above the base.",
    "Harder levels introduce fun bonus terrain tiles; level 10 uses every tile type in the legend."
  ],
  "levels": [
    {
      "id": 1,
      "name": "Level 1",
      "difficulty": 1,
      "size": {
        "width": 25,
        "height": 19
      },
      "base": {
        "x": 12,
        "y": 17
      },
      "layout": [
        "@@@@@@@@@@@@@@@@@@@@@@@@@",
        "@.......................@",
        "@.......................@",
        "@.......................@",
        "@...%%.............%%...@",
        "@...%%.............%%...@",
        "@......###########......@",
        "@.......................@",
        "@........~~...~~........@",
        "@.......................@",
        "@.......................@",
        "@.....#####...#####.....@",
        "@...........#...........@",
        "@...........#...........@",
        "@...__......#......__...@",
        "@...........#...........@",
        "@..........###..........@",
        "@..........#B#..........@",
        "@@@@@@@@@@@@@@@@@@@@@@@@@"
      ]
    },
    {
      "id": 2,
      "name": "Level 2",
      "difficulty": 2,
      "size": {
        "width": 25,
        "height": 19
      },
      "base": {
        "x": 12,
        "y": 17
      },
      "layout": [
        "@@@@@@@@@@@@@@@@@@@@@@@@@",
        "@.......................@",
        "@.......................@",
        "@.......................@",
        "@...#...#._____.#...#...@",
        "@.%%#...#.......#...#%%.@",
        "@.%%#...#.......#...#%%.@",
        "@.%%#.#############.#%%.@",
        "@...#...#..~~~..#...#...@",
        "@...#...#.......#...#...@",
        "@.~~#...#.......#...#~~.@",
        "@.~~###@#########@###~~.@",
        "@...#...#...#...#...#...@",
        "@...........#...........@",
        "@.####......#......####.@",
        "@...........#...........@",
        "@..........###..........@",
        "@..........#B#..........@",
        "@@@@@@@@@@@@@@@@@@@@@@@@@"
      ]
    },
    {
      "id": 3,
      "name": "Level 3",
      "difficulty": 3,
      "size": {
        "width": 25,
        "height": 19
      },
      "base": {
        "x": 12,
        "y": 17
      },
      "layout": [
        "@@@@@@@@@@@@@@@@@@@@@@@@@",
        "@.......................@",
        "@.......................@",
        "@..........___..........@",
        "@..#######.....#######..@",
        "@..FFF....#...#....FFF..@",
        "@.....C...#...#...C.....@",
        "@....~~~..#...#..~~~....@",
        "@....~~~..#...#..~~~....@",
        "@....~~~MM#...#MM~~~....@",
        "@.........#.#.#.........@",
        "@.%%%%....#.#.#....%%%%.@",
        "@.%%%%....#.#.#....%%%%.@",
        "@........#######........@",
        "@.......R...#...R.......@",
        "@...#################...@",
        "@..........###..........@",
        "@..........#B#..........@",
        "@@@@@@@@@@@@@@@@@@@@@@@@@"
      ]
    },
    {
      "id": 4,
      "name": "Level 4",
      "difficulty": 4,
      "size": {
        "width": 25,
        "height": 19
      },
      "base": {
        "x": 12,
        "y": 17
      },
      "layout": [
        "@@@@@@@@@@@@@@@@@@@@@@@@@",
        "@.......................@",
        "@.......................@",
        "@.......................@",
        "@..#...#.........#...#..@",
        "@..#.@G@@@@@@@@@@@G@.#..@",
        "@..#...#.........#...#..@",
        "@..#.P.#...~~~...#.P.#..@",
        "@..#...#.LL~~~LL.#...#..@",
        "@..#...#.........#...#..@",
        "@..#.###############.#..@",
        "@..#...#....#....#...#..@",
        "@..#...#.S..#..S.#...#..@",
        "@.%%%%.#...O#O...#.%%%%.@",
        "@.%%%%.#....#....#.%%%%.@",
        "@.......................@",
        "@..........###..........@",
        "@..........#B#..........@",
        "@@@@@@@@@@@@@@@@@@@@@@@@@"
      ]
    },
    {
      "id": 5,
      "name": "Level 5",
      "difficulty": 5,
      "size": {
        "width": 25,
        "height": 19
      },
      "base": {
        "x": 12,
        "y": 17
      },
      "layout": [
        "@@@@@@@@@@@@@@@@@@@@@@@@@",
        "@.......................@",
        "@.......................@",
        "@.......................@",
        "@.##C######...######C##.@",
        "@.....@....FFF....@.....@",
        "@.....@...%%%%%...@.....@",
        "@.....G...%%%%%...G.....@",
        "@.####@##R%%%%%R##@####.@",
        "@.....@...........@.....@",
        "@.....@..P.....P..@.....@",
        "@.....@...~~~~~...@.....@",
        "@.##M#@###~~~~~###@#M##.@",
        "@.....G.....S.....G.....@",
        "@.....@...........@.....@",
        "@........#######........@",
        "@..........###..........@",
        "@..........#B#..........@",
        "@@@@@@@@@@@@@@@@@@@@@@@@@"
      ]
    },
    {
      "id": 6,
      "name": "Level 6",
      "difficulty": 6,
      "size": {
        "width": 25,
        "height": 19
      },
      "base": {
        "x": 12,
        "y": 17
      },
      "layout": [
        "@@@@@@@@@@@@@@@@@@@@@@@@@",
        "@.......................@",
        "@.......................@",
        "@...#...#...#...#...#...@",
        "@..%#%%%#.FF#FF.#%%%#%..@",
        "@..%#%%%#.FF#FF.#%%%#%..@",
        "@..%#%%%#...#...#%%%#%..@",
        "@...#.@@@@@@@@@@@@@.#...@",
        "@...#.C.#...#...#.C.#...@",
        "@...#~~~#...#...#~~~#...@",
        "@...#~~~#...#...#~~~#...@",
        "@...#~~~#...#...#~~~#...@",
        "@...#...#.R.#.R.#...#...@",
        "@..###################..@",
        "@...#...#...G...#...#...@",
        "@...#...#...#...#...#...@",
        "@..........###..........@",
        "@..........#B#..........@",
        "@@@@@@@@@@@@@@@@@@@@@@@@@"
      ]
    },
    {
      "id": 7,
      "name": "Level 7",
      "difficulty": 7,
      "size": {
        "width": 25,
        "height": 19
      },
      "base": {
        "x": 12,
        "y": 17
      },
      "layout": [
        "@@@@@@@@@@@@@@@@@@@@@@@@@",
        "@.......................@",
        "@.......................@",
        "@....#...#.....#...#....@",
        "@....#...#.@@@.#...#....@",
        "@....#...#S@@@S#...#....@",
        "@..####L###@@@###L####..@",
        "@....#...#.X.X.#...#....@",
        "@.___#...#.....#...#___.@",
        "@.___#...#..T..#...#___.@",
        "@..####O#########O####..@",
        "@..MM#...#.....#...#MM..@",
        "@..MM#...#P...P#...#MM..@",
        "@....#...#~~~~~#...#....@",
        "@..####N#########N####..@",
        "@....#...#.....#...#....@",
        "@..........###..........@",
        "@..........#B#..........@",
        "@@@@@@@@@@@@@@@@@@@@@@@@@"
      ]
    },
    {
      "id": 8,
      "name": "Level 8",
      "difficulty": 8,
      "size": {
        "width": 25,
        "height": 19
      },
      "base": {
        "x": 12,
        "y": 17
      },
      "layout": [
        "@@@@@@@@@@@@@@@@@@@@@@@@@",
        "@.......................@",
        "@.......................@",
        "@.#####################.@",
        "@....#..___#.#___..#....@",
        "@..P.#..___#.#___..#.P..@",
        "@.#####################.@",
        "@....#.LL..#.#..LL.#....@",
        "@....#.LL..#.#..LL.#....@",
        "@.@@@#@@@@@#@#@@@@@#@@@.@",
        "@.~~~~...S.#.#.S...~~~~.@",
        "@.~~~~.....#.#.....~~~~.@",
        "@.#####################.@",
        "@....#.MMM.#.#.MMM.#....@",
        "@....#.....#T#.....#....@",
        "@.#####################.@",
        "@..........###..........@",
        "@..........#B#..........@",
        "@@@@@@@@@@@@@@@@@@@@@@@@@"
      ]
    },
    {
      "id": 9,
      "name": "Level 9",
      "difficulty": 9,
      "size": {
        "width": 25,
        "height": 19
      },
      "base": {
        "x": 12,
        "y": 17
      },
      "layout": [
        "@@@@@@@@@@@@@@@@@@@@@@@@@",
        "@.......................@",
        "@.......................@",
        "@.#.@.#.@.#.@.#.@.#.@.#.@",
        "@.#.@O#.@.#.@.#.@.#O@.#.@",
        "@.#####################.@",
        "@.#.@.~~~~#.@.#~~~~.@.#.@",
        "@.#.@.~~~~#X@X#~~~~.@.#.@",
        "@.#.@.#.@.#.T.#.@.#.@.#.@",
        "@.#####################.@",
        "@.#.@.NN@.%%%%%.@NN.@.#.@",
        "@.#.@.NN@.%%%%%.@NN.@.#.@",
        "@.#.@.#.@.%%%%%.@.#.@.#.@",
        "@.#####################.@",
        "@.#.@.#.@P#.@.#S@.#.@.#.@",
        "@.#.@.#.@@@@@@@@@.#.@.#.@",
        "@..........###..........@",
        "@..........#B#..........@",
        "@@@@@@@@@@@@@@@@@@@@@@@@@"
      ]
    },
    {
      "id": 10,
      "name": "Level 10",
      "difficulty": 10,
      "size": {
        "width": 25,
        "height": 19
      },
      "base": {
        "x": 12,
        "y": 17
      },
      "layout": [
        "@@@@@@@@@@@@@@@@@@@@@@@@@",
        "@.......................@",
        "@.......................@",
        "@.#####################.@",
        "@..#C.#.G.#...#.G.#.C#..@",
        "@.@#@@#~~~~L@L~~~~#@@#@.@",
        "@..#.F#~~~~...~~~~#F.#..@",
        "@.#####################.@",
        "@..#M.#...#%%%#...#.M#..@",
        "@.@#@@#@R@#%%%#@R@#@@#@.@",
        "@..#.P#...#%%%#...#P.#..@",
        "@.###____#######____###.@",
        "@..#.____.#OTO#.____.#..@",
        "@.@#@@#@@S#@@@#S@@#@@#@.@",
        "@..#..#N..X...X..N#..#..@",
        "@.########@@@@@########.@",
        "@..........###..........@",
        "@..........#B#..........@",
        "@@@@@@@@@@@@@@@@@@@@@@@@@"
      ]
    }
  ]
}
